1111111111111111111
111100000000011E011
1000011111001100001
1P001100000C110C011
1111000100111110111
11100C0100111110111
10010000C0001100101
10000111110C0000001
1C0011E0000010C0011
10000000C0011111111
1111111111111111111
