111111111111111111111111111111111111111111111111111111111111111111111111111111111111111111111111111111
100000000000000000000000000000000000000000000000000000000000000000000000000000000000000000000000000001
100000000000000000000000000000000000000000000000000000000000000000000000000000000000000000000000000001
100000000000000000000000000000000000000000000000000000000000000000000000000000000000000000000000000001
100000000000000000000011100000000000000000000000000000000000000000000000000000000000000000000000000001
10000000000C00000000000C100000000000000000000000000000000000000000000000000000000000000000000000000001
1000000000000000000000001E01000000000000000000000000000000000000S00000000e0000000000000000000000000001
100000000000000000000C00001111111111111110111111100100000000000000000B000S0000000000000000000000000001
1000000000000000000000000000100000001110000000000000000000000000000000000B0000000000000000000000000001
1000000000000000000000000000100SC0SC1110000S0001100100000000000001111001111000100010000000000000000001
1000000000000000000000000000100CS00S111000SSS000000111000000e00000000000000000100010000000000000000001
1000000000000000000000001100100000000000000S00011001B1000000000000000000000000100010000e00000000000001
1000000000001100000000001100000000100010000000010001110011000000011110011110P0000000000000000000000001
100000000000000000000000110010000C000000111011111000100000000000000000000000000000000e0000000000000001
100000000000000000000000110010011110000S0B0000000000010000000B00000000111111111000100B0000000000000001
100000000000000000000000000000000000110000101000000000000000000010111110001000100010000000000000000001
1000000000000000000000000000000000001100001C1001110000000000000010100010100010100010000000000000000001
1000000000000000000000000000000000001100B0101001110000000111110010101010111110100000000000000000000001
100000000000000000000000000000000000000B0B00000000000000010001001000100010001010000B000000000000000001
1000000000000000000000000000000000000000B0000000000000000100B10010111111101000100000000000000000000001
100000000000000111111111111111111111100000011100000000000100000000000000001111100000000000000000000001
100000000000000000000000000000000000000000000000000000000111110011111111111000000000000000000000000001
1000000000000000000000000000000000000000000000000000000000000S0000000000000000000000000000000000000001
10000000000000000000000000000000000000000000000000000000000000000000000S000000000000000000000000000001
100000000000000000000000000000000000000000000000000000000000000000000000000000000000000000000000000001
100000000000000000000000000000000000000000000000000000000000000000000000000000000000000000000000000001
100000000000000000000000000000000000000000000000000000000000000000000000000000000000000000000000000001
100000000000000000000000000000000000000000000000000000000000000000000000000000000000000000000000000001
100000000000000000000000000000000000000000000000000000000000000000000000000000000000000000000000000001
100000000000000000000000000000000000000000000000000000000000000000000000000000000000000000000000000001
100000000000000000000000000000000000000000000000000000000000000000000000000000000000000000000000000001
111111111111111111111111111111111111111111111111111111111111111111111111111111111111111111111111111111