  
   
  
111111111111111111111111111111111111111111
100000000000000000000000000000000000000001
1000P0000000000000000000000000000000000001
100000010000000000000000000000000000000001
100000011100000000000011100000000000000001
10000000000C00000000000C100000000000000001
1001110000000000000000001E0100000000000001
100000000000000000000C00001111111111111111
100000000000000000000000000010000000111001
1000000000000000000000000000100SC0SC111001
1000000000000000000000000000100CS00S111001
100000000000000000000000110010000000000001
100000000000110000000000110000000010001001
111111111111111111111111111111111111111111



